{
  "name": "Level 1",
  "order": 1,
  "map": [
    "xxxxxxxxxxxxxxxx",
    "x........p.....x",
    "x..............x",
    "x..............x",
    "x..............x",
    "x..............x",
    "x..............x",
    "x.....#....o...x",
    "x..............x",
    "x..............x",
    "x..............x",
    "x..............x",
    "x..............x",
    "x..............x",
    "x..............x",
    "xxxxxxxxxxxxxxxx"
  ]
}
